char[] map = [
{
     '#', '#', '#', '#', '#', '#', '#', '#', '#', '#', '#', '#', '#', '#', '#', '#', '#', '#', '#', '#', '#', '#', '#', '#', '#', '#', '#', '#', '#', '#', '#', '#', '#', '#', '#', '#', '#', '#', '#', '#', '#', '#', '#', '#', '#', '#', '#', '#', '#', '#', '#', '#', '#', '#', '#', '#', '#', '#', '#', '#', '#', '#', '#', '#', 
     '#', ' ', ' ', ' ', ' ', ' ', ' ', ' ', ' ', ' ', ' ', ' ', ' ', ' ', ' ', ' ', ' ', ' ', ' ', ' ', '#', ' ', ' ', ' ', ' ', ' ', ' ', ' ', '#', ' ', ' ', ' ', ' ', ' ', ' ', ' ', ' ', ' ', ' ', '#', ' ', ' ', ' ', ' ', ' ', ' ', ' ', ' ', ' ', ' ', ' ', ' ', '#', ' ', ' ', ' ', ' ', ' ', ' ', '#', ' ', ' ', ' ', '#', 
     '#', ' ', ' ', ' ', ' ', ' ', ' ', ' ', ' ', ' ', ' ', ' ', ' ', ' ', ' ', ' ', ' ', ' ', ' ', ' ', '#', ' ', ' ', ' ', ' ', ' ', ' ', ' ', '#', ' ', ' ', ' ', ' ', ' ', ' ', ' ', ' ', ' ', ' ', '#', ' ', ' ', ' ', ' ', ' ', ' ', ' ', ' ', ' ', ' ', ' ', ' ', '#', ' ', ' ', ' ', ' ', ' ', ' ', '#', ' ', ' ', ' ', '#', 
     '#', ' ', ' ', ' ', ' ', ' ', ' ', ' ', ' ', ' ', ' ', ' ', ' ', ' ', ' ', ' ', ' ', ' ', ' ', ' ', '#', ' ', ' ', ' ', ' ', ' ', ' ', ' ', '#', ' ', ' ', ' ', ' ', ' ', ' ', ' ', ' ', ' ', ' ', '#', ' ', ' ', ' ', ' ', ' ', ' ', ' ', ' ', ' ', ' ', ' ', ' ', '#', ' ', ' ', ' ', '#', '#', '#', '#', ' ', ' ', ' ', '#', 
     '#', ' ', ' ', ' ', '#', '#', '#', '#', '#', ' ', ' ', ' ', '#', '#', '#', '#', '#', ' ', ' ', ' ', '#', ' ', ' ', ' ', '#', ' ', ' ', ' ', '#', '#', '#', '#', '#', '#', '#', '#', ' ', ' ', ' ', '#', '#', '#', '#', '#', '#', ' ', ' ', ' ', '#', ' ', ' ', ' ', '#', ' ', ' ', ' ', ' ', ' ', ' ', '#', ' ', ' ', ' ', '#', 
     '#', ' ', ' ', ' ', ' ', ' ', ' ', ' ', '#', ' ', ' ', ' ', ' ', ' ', ' ', ' ', '#', ' ', ' ', ' ', '#', ' ', ' ', ' ', '#', ' ', ' ', ' ', ' ', ' ', ' ', ' ', ' ', ' ', ' ', ' ', ' ', ' ', ' ', '#', ' ', ' ', ' ', ' ', ' ', ' ', ' ', ' ', '#', ' ', ' ', ' ', '#', ' ', ' ', ' ', ' ', ' ', ' ', '#', ' ', ' ', ' ', '#', 
     '#', ' ', ' ', ' ', ' ', ' ', ' ', ' ', '#', ' ', ' ', ' ', ' ', ' ', ' ', ' ', '#', ' ', ' ', ' ', '#', ' ', ' ', ' ', '#', ' ', ' ', ' ', ' ', ' ', ' ', ' ', ' ', ' ', ' ', ' ', ' ', ' ', ' ', '#', ' ', ' ', ' ', ' ', ' ', ' ', ' ', ' ', '#', ' ', ' ', ' ', '#', ' ', ' ', ' ', ' ', ' ', ' ', '#', ' ', ' ', ' ', '#', 
     '#', ' ', ' ', ' ', ' ', ' ', ' ', ' ', '#', ' ', ' ', ' ', ' ', ' ', ' ', ' ', '#', ' ', ' ', ' ', '#', ' ', ' ', ' ', '#', ' ', ' ', ' ', ' ', ' ', ' ', ' ', ' ', ' ', ' ', ' ', ' ', ' ', ' ', '#', ' ', ' ', ' ', ' ', ' ', ' ', ' ', ' ', '#', ' ', ' ', ' ', '#', ' ', ' ', ' ', ' ', ' ', ' ', '#', ' ', ' ', ' ', '#', 
     '#', '#', '#', '#', '#', ' ', ' ', ' ', '#', ' ', ' ', ' ', '#', ' ', ' ', ' ', '#', ' ', ' ', ' ', '#', ' ', ' ', ' ', '#', '#', '#', '#', '#', '#', '#', '#', '#', '#', '#', '#', '#', '#', '#', '#', ' ', ' ', ' ', '#', '#', '#', '#', '#', '#', ' ', ' ', ' ', '#', '#', '#', '#', ' ', ' ', ' ', '#', ' ', ' ', ' ', '#', 
     '#', ' ', ' ', ' ', ' ', ' ', ' ', ' ', '#', ' ', ' ', ' ', '#', ' ', ' ', ' ', ' ', ' ', ' ', ' ', '#', ' ', ' ', ' ', ' ', ' ', ' ', ' ', ' ', '#', ' ', ' ', ' ', ' ', ' ', ' ', ' ', ' ', ' ', '#', ' ', ' ', ' ', '#', ' ', ' ', ' ', ' ', ' ', ' ', ' ', ' ', '#', ' ', ' ', ' ', ' ', ' ', ' ', ' ', ' ', ' ', ' ', '#', 
     '#', ' ', ' ', ' ', ' ', ' ', ' ', ' ', '#', ' ', ' ', ' ', '#', ' ', ' ', ' ', ' ', ' ', ' ', ' ', '#', ' ', ' ', ' ', ' ', ' ', ' ', ' ', ' ', '#', ' ', ' ', ' ', ' ', ' ', ' ', ' ', ' ', ' ', '#', ' ', ' ', ' ', '#', ' ', ' ', ' ', ' ', ' ', ' ', ' ', ' ', '#', ' ', ' ', ' ', ' ', ' ', ' ', ' ', ' ', ' ', ' ', '#', 
     '#', ' ', ' ', ' ', ' ', ' ', ' ', ' ', '#', ' ', ' ', ' ', '#', ' ', ' ', ' ', ' ', ' ', ' ', ' ', '#', ' ', ' ', ' ', ' ', ' ', ' ', ' ', ' ', '#', ' ', ' ', ' ', ' ', ' ', ' ', ' ', ' ', ' ', '#', ' ', ' ', ' ', '#', ' ', ' ', ' ', ' ', ' ', ' ', ' ', ' ', '#', ' ', ' ', ' ', ' ', ' ', ' ', ' ', ' ', ' ', ' ', '#', 
     '#', ' ', ' ', ' ', '#', '#', '#', '#', '#', '#', '#', '#', '#', '#', '#', '#', '#', '#', '#', '#', '#', '#', '#', '#', '#', '#', ' ', ' ', ' ', '#', '#', '#', '#', ' ', ' ', ' ', '#', '#', '#', '#', ' ', ' ', ' ', '#', ' ', ' ', ' ', ' ', ' ', '#', '#', '#', '#', '#', '#', '#', '#', '#', '#', '#', ' ', ' ', ' ', '#', 
     '#', ' ', ' ', ' ', '#', ' ', ' ', ' ', '#', ' ', ' ', ' ', ' ', ' ', ' ', ' ', ' ', ' ', ' ', ' ', ' ', ' ', ' ', ' ', ' ', ' ', ' ', ' ', ' ', '#', ' ', ' ', '#', ' ', ' ', ' ', ' ', ' ', ' ', '#', ' ', ' ', ' ', '#', ' ', ' ', ' ', ' ', ' ', ' ', ' ', '#', ' ', ' ', ' ', ' ', ' ', ' ', ' ', ' ', ' ', ' ', ' ', '#', 
     '#', ' ', ' ', ' ', '#', ' ', ' ', ' ', '#', ' ', ' ', ' ', ' ', ' ', ' ', ' ', ' ', ' ', ' ', ' ', ' ', ' ', ' ', ' ', ' ', ' ', ' ', ' ', ' ', '#', ' ', ' ', '#', ' ', ' ', ' ', ' ', ' ', ' ', '#', ' ', ' ', ' ', '#', ' ', ' ', ' ', ' ', ' ', ' ', ' ', '#', ' ', ' ', ' ', ' ', ' ', ' ', ' ', ' ', ' ', ' ', ' ', '#', 
     '#', ' ', ' ', ' ', '#', ' ', ' ', ' ', '#', ' ', ' ', ' ', ' ', ' ', ' ', ' ', ' ', ' ', ' ', ' ', ' ', ' ', ' ', ' ', ' ', ' ', ' ', ' ', ' ', '#', ' ', ' ', '#', ' ', ' ', ' ', ' ', ' ', ' ', '#', ' ', ' ', ' ', '#', ' ', ' ', ' ', ' ', ' ', ' ', ' ', '#', ' ', ' ', ' ', ' ', ' ', ' ', ' ', ' ', ' ', ' ', ' ', '#', 
     '#', ' ', ' ', ' ', '#', ' ', ' ', ' ', ' ', ' ', ' ', ' ', '#', '#', '#', '#', '#', '#', '#', '#', '#', '#', '#', '#', '#', '#', '#', '#', '#', '#', ' ', ' ', '#', '#', '#', '#', ' ', ' ', ' ', ' ', ' ', ' ', ' ', '#', '#', '#', '#', '#', ' ', ' ', ' ', '#', ' ', ' ', ' ', '#', ' ', ' ', ' ', '#', '#', '#', '#', '#', 
     '#', ' ', ' ', ' ', '#', ' ', ' ', ' ', ' ', ' ', ' ', ' ', ' ', ' ', ' ', ' ', ' ', ' ', ' ', ' ', '#', ' ', ' ', ' ', ' ', ' ', ' ', ' ', '#', ' ', ' ', ' ', '#', ' ', ' ', ' ', ' ', ' ', ' ', ' ', ' ', ' ', ' ', ' ', ' ', ' ', ' ', '#', ' ', ' ', ' ', '#', ' ', ' ', ' ', '#', ' ', ' ', ' ', ' ', ' ', ' ', ' ', '#', 
     '#', ' ', ' ', ' ', ' ', ' ', ' ', ' ', ' ', ' ', ' ', ' ', ' ', ' ', ' ', ' ', ' ', ' ', ' ', ' ', '#', ' ', ' ', ' ', ' ', ' ', ' ', ' ', '#', ' ', ' ', ' ', '#', ' ', ' ', ' ', ' ', ' ', ' ', ' ', ' ', ' ', ' ', ' ', ' ', ' ', ' ', '#', ' ', ' ', ' ', '#', ' ', ' ', ' ', '#', ' ', ' ', ' ', ' ', ' ', ' ', ' ', '#', 
     '#', ' ', ' ', ' ', ' ', ' ', ' ', ' ', '#', ' ', ' ', ' ', ' ', ' ', ' ', ' ', ' ', ' ', ' ', ' ', '#', ' ', ' ', ' ', ' ', ' ', ' ', ' ', '#', ' ', ' ', ' ', '#', '#', '#', '#', '#', '#', '#', ' ', ' ', ' ', ' ', ' ', ' ', ' ', ' ', '#', ' ', ' ', ' ', '#', ' ', ' ', ' ', '#', ' ', ' ', ' ', ' ', ' ', ' ', ' ', '#', 
     '#', ' ', ' ', ' ', ' ', ' ', ' ', ' ', '#', '#', '#', '#', '#', '#', '#', '#', '#', ' ', ' ', ' ', ' ', ' ', ' ', ' ', '#', ' ', ' ', ' ', ' ', ' ', ' ', ' ', ' ', ' ', ' ', ' ', ' ', ' ', '#', ' ', ' ', ' ', ' ', ' ', ' ', ' ', ' ', '#', ' ', ' ', ' ', ' ', ' ', ' ', ' ', '#', '#', '#', '#', '#', '#', '#', '#', '#', 
     '#', '#', '#', '#', '#', '#', '#', '#', '#', ' ', ' ', ' ', '#', ' ', ' ', ' ', '#', ' ', ' ', ' ', ' ', ' ', ' ', ' ', '#', ' ', ' ', ' ', ' ', ' ', ' ', ' ', ' ', ' ', ' ', ' ', ' ', ' ', '#', ' ', ' ', ' ', ' ', ' ', ' ', ' ', ' ', '#', ' ', ' ', ' ', ' ', ' ', ' ', ' ', '#', ' ', ' ', ' ', ' ', ' ', ' ', ' ', '#', 
     '#', ' ', ' ', ' ', '#', ' ', ' ', ' ', '#', ' ', ' ', ' ', '#', ' ', ' ', ' ', '#', ' ', ' ', ' ', ' ', ' ', ' ', ' ', '#', ' ', ' ', ' ', ' ', ' ', ' ', ' ', ' ', ' ', ' ', ' ', ' ', ' ', '#', ' ', ' ', ' ', ' ', ' ', ' ', ' ', ' ', '#', ' ', ' ', ' ', ' ', ' ', ' ', ' ', '#', ' ', ' ', ' ', ' ', ' ', ' ', ' ', '#', 
     '#', ' ', ' ', ' ', '#', ' ', ' ', ' ', '#', ' ', ' ', ' ', ' ', ' ', ' ', ' ', '#', '#', '#', '#', '#', '#', '#', '#', '#', '#', '#', '#', '#', '#', '#', '#', '#', '#', '#', ' ', ' ', ' ', '#', '#', '#', '#', '#', '#', ' ', ' ', ' ', '#', '#', '#', '#', '#', '#', '#', '#', '#', ' ', ' ', ' ', '#', ' ', ' ', ' ', '#', 
     '#', ' ', ' ', ' ', '#', ' ', ' ', ' ', ' ', ' ', ' ', ' ', ' ', ' ', ' ', ' ', ' ', ' ', ' ', ' ', ' ', ' ', ' ', ' ', ' ', '#', ' ', ' ', ' ', ' ', ' ', ' ', ' ', ' ', ' ', ' ', ' ', ' ', ' ', ' ', ' ', ' ', ' ', ' ', ' ', ' ', ' ', ' ', ' ', ' ', ' ', ' ', ' ', ' ', ' ', '#', ' ', ' ', ' ', '#', ' ', ' ', ' ', '#', 
     '#', ' ', ' ', ' ', '#', ' ', ' ', ' ', ' ', ' ', ' ', ' ', ' ', ' ', ' ', ' ', ' ', ' ', ' ', ' ', ' ', ' ', ' ', ' ', ' ', '#', ' ', ' ', ' ', ' ', ' ', ' ', ' ', ' ', ' ', ' ', ' ', ' ', ' ', ' ', ' ', ' ', ' ', ' ', ' ', ' ', ' ', ' ', ' ', ' ', ' ', ' ', ' ', ' ', ' ', '#', ' ', ' ', ' ', '#', ' ', ' ', ' ', '#', 
     '#', ' ', ' ', ' ', '#', ' ', ' ', ' ', ' ', ' ', ' ', ' ', ' ', ' ', ' ', ' ', ' ', ' ', ' ', ' ', ' ', ' ', ' ', ' ', ' ', '#', ' ', ' ', ' ', ' ', ' ', ' ', ' ', ' ', ' ', ' ', ' ', ' ', ' ', ' ', ' ', ' ', ' ', ' ', ' ', ' ', ' ', ' ', ' ', ' ', ' ', ' ', ' ', ' ', ' ', '#', ' ', ' ', ' ', '#', ' ', ' ', ' ', '#', 
     '#', ' ', ' ', ' ', '#', ' ', ' ', ' ', ' ', ' ', ' ', ' ', ' ', ' ', ' ', ' ', '#', ' ', ' ', ' ', ' ', '#', ' ', ' ', ' ', '#', '#', '#', '#', '#', '#', '#', '#', '#', '#', '#', '#', '#', '#', '#', '#', '#', '#', '#', '#', '#', '#', '#', '#', '#', '#', '#', ' ', ' ', ' ', '#', ' ', ' ', ' ', '#', ' ', ' ', ' ', '#', 
     '#', ' ', ' ', ' ', '#', ' ', ' ', ' ', ' ', ' ', ' ', '#', '#', '#', '#', '#', '#', '#', '#', '#', '#', '#', ' ', ' ', ' ', ' ', ' ', ' ', ' ', ' ', ' ', ' ', ' ', ' ', ' ', ' ', ' ', ' ', ' ', '#', ' ', ' ', ' ', ' ', ' ', ' ', ' ', ' ', ' ', ' ', ' ', '#', ' ', ' ', ' ', '#', ' ', ' ', ' ', '#', ' ', ' ', ' ', '#', 
     '#', ' ', ' ', ' ', '#', ' ', ' ', ' ', ' ', ' ', ' ', '#', ' ', ' ', ' ', ' ', ' ', ' ', ' ', ' ', ' ', '#', ' ', ' ', ' ', ' ', ' ', ' ', ' ', ' ', ' ', ' ', ' ', ' ', ' ', ' ', ' ', ' ', ' ', '#', ' ', ' ', ' ', ' ', ' ', ' ', ' ', ' ', ' ', ' ', ' ', '#', ' ', ' ', ' ', '#', ' ', ' ', ' ', '#', ' ', ' ', ' ', '#', 
     '#', ' ', ' ', ' ', '#', ' ', ' ', ' ', ' ', ' ', ' ', '#', ' ', ' ', ' ', ' ', ' ', ' ', ' ', ' ', ' ', '#', ' ', ' ', ' ', ' ', ' ', ' ', ' ', ' ', ' ', ' ', ' ', ' ', ' ', ' ', ' ', ' ', ' ', '#', ' ', ' ', ' ', ' ', ' ', ' ', ' ', ' ', ' ', ' ', ' ', '#', ' ', ' ', ' ', '#', ' ', ' ', ' ', '#', ' ', ' ', ' ', '#', 
     '#', ' ', ' ', ' ', '#', ' ', ' ', ' ', ' ', ' ', ' ', '#', ' ', ' ', ' ', ' ', ' ', ' ', ' ', ' ', ' ', '#', ' ', ' ', ' ', ' ', '#', '#', '#', '#', '#', '#', '#', '#', '#', '#', '#', '#', '#', '#', ' ', ' ', ' ', '#', '#', '#', '#', '#', ' ', ' ', ' ', '#', ' ', ' ', ' ', '#', ' ', ' ', ' ', '#', ' ', ' ', ' ', '#', 
     '#', ' ', ' ', ' ', '#', ' ', ' ', ' ', ' ', ' ', ' ', '#', '#', '#', '#', '#', '#', ' ', ' ', ' ', '#', '#', ' ', ' ', ' ', ' ', '#', ' ', ' ', ' ', ' ', ' ', ' ', ' ', ' ', ' ', ' ', ' ', ' ', ' ', ' ', ' ', ' ', '#', ' ', ' ', ' ', '#', ' ', ' ', ' ', ' ', ' ', ' ', ' ', '#', ' ', ' ', ' ', '#', ' ', ' ', ' ', '#', 
     '#', ' ', ' ', ' ', '#', ' ', ' ', ' ', ' ', ' ', ' ', '#', ' ', ' ', ' ', ' ', '#', ' ', ' ', ' ', ' ', '#', ' ', ' ', ' ', ' ', '#', ' ', ' ', ' ', ' ', ' ', ' ', ' ', ' ', ' ', ' ', ' ', ' ', ' ', ' ', ' ', ' ', '#', ' ', ' ', ' ', '#', ' ', ' ', ' ', ' ', ' ', ' ', ' ', '#', ' ', ' ', ' ', '#', ' ', ' ', ' ', '#', 
     '#', ' ', ' ', ' ', '#', ' ', ' ', ' ', ' ', ' ', ' ', '#', ' ', ' ', ' ', ' ', '#', ' ', ' ', ' ', ' ', '#', ' ', ' ', ' ', ' ', '#', ' ', ' ', ' ', ' ', ' ', ' ', ' ', ' ', ' ', ' ', ' ', ' ', ' ', ' ', ' ', ' ', '#', ' ', ' ', ' ', '#', ' ', ' ', ' ', ' ', ' ', ' ', ' ', '#', ' ', ' ', ' ', '#', '#', '#', '#', '#', 
     '#', ' ', ' ', ' ', '#', ' ', ' ', ' ', '#', '#', '#', '#', ' ', ' ', ' ', ' ', '#', ' ', ' ', ' ', ' ', '#', ' ', ' ', ' ', ' ', '#', ' ', ' ', ' ', '#', '#', '#', '#', '#', '#', '#', '#', '#', '#', ' ', ' ', ' ', '#', ' ', ' ', ' ', '#', '#', '#', '#', '#', '#', '#', '#', '#', ' ', ' ', ' ', '#', ' ', ' ', ' ', '#', 
     '#', ' ', ' ', ' ', ' ', ' ', ' ', ' ', ' ', ' ', ' ', '#', ' ', ' ', ' ', ' ', '#', '#', ' ', ' ', ' ', '#', ' ', ' ', ' ', ' ', '#', ' ', ' ', ' ', '#', ' ', ' ', ' ', ' ', '#', ' ', ' ', ' ', '#', ' ', ' ', ' ', ' ', ' ', ' ', ' ', ' ', ' ', ' ', ' ', ' ', ' ', ' ', ' ', ' ', ' ', ' ', ' ', '#', ' ', ' ', ' ', '#', 
     '#', ' ', ' ', ' ', ' ', ' ', ' ', ' ', ' ', ' ', ' ', '#', ' ', ' ', ' ', ' ', '#', ' ', ' ', ' ', ' ', '#', ' ', ' ', ' ', ' ', '#', ' ', ' ', ' ', '#', ' ', ' ', ' ', ' ', '#', ' ', ' ', ' ', '#', ' ', ' ', ' ', ' ', ' ', ' ', ' ', ' ', ' ', ' ', ' ', ' ', ' ', ' ', ' ', ' ', ' ', ' ', ' ', '#', ' ', ' ', ' ', '#', 
     '#', ' ', ' ', ' ', '#', '#', '#', '#', '#', '#', '#', '#', ' ', ' ', ' ', ' ', '#', ' ', ' ', ' ', ' ', '#', ' ', ' ', ' ', ' ', '#', ' ', ' ', ' ', '#', ' ', ' ', ' ', ' ', '#', ' ', ' ', ' ', '#', ' ', ' ', ' ', ' ', ' ', ' ', ' ', ' ', ' ', ' ', ' ', ' ', ' ', ' ', ' ', ' ', ' ', ' ', ' ', '#', ' ', ' ', ' ', '#', 
     '#', ' ', ' ', ' ', '#', ' ', ' ', ' ', ' ', ' ', ' ', ' ', ' ', ' ', ' ', ' ', ' ', ' ', ' ', ' ', ' ', '#', ' ', ' ', ' ', ' ', '#', ' ', ' ', ' ', ' ', ' ', ' ', ' ', ' ', ' ', ' ', ' ', ' ', '#', '#', '#', '#', '#', '#', '#', '#', '#', '#', '#', '#', '#', '#', '#', '#', '#', '#', '#', '#', '#', ' ', ' ', ' ', '#', 
     '#', ' ', ' ', ' ', '#', ' ', ' ', ' ', ' ', ' ', ' ', ' ', ' ', ' ', ' ', ' ', ' ', ' ', ' ', ' ', ' ', '#', ' ', ' ', ' ', ' ', '#', ' ', ' ', ' ', ' ', ' ', ' ', ' ', ' ', ' ', ' ', ' ', ' ', ' ', ' ', ' ', ' ', ' ', ' ', ' ', '#', ' ', ' ', ' ', ' ', ' ', ' ', ' ', ' ', ' ', ' ', ' ', ' ', ' ', ' ', ' ', ' ', '#', 
     '#', ' ', ' ', ' ', '#', ' ', ' ', ' ', ' ', ' ', ' ', ' ', ' ', ' ', ' ', ' ', ' ', ' ', ' ', ' ', ' ', '#', ' ', ' ', ' ', ' ', '#', ' ', ' ', ' ', ' ', ' ', ' ', ' ', ' ', ' ', ' ', ' ', ' ', ' ', ' ', ' ', ' ', ' ', ' ', ' ', '#', '#', '#', '#', '#', '#', '#', ' ', ' ', ' ', ' ', ' ', ' ', ' ', ' ', ' ', ' ', '#', 
     '#', ' ', ' ', ' ', '#', ' ', ' ', '#', '#', '#', '#', '#', '#', '#', '#', '#', '#', '#', '#', '#', '#', '#', ' ', ' ', ' ', ' ', '#', ' ', ' ', ' ', '#', ' ', ' ', ' ', ' ', '#', ' ', ' ', ' ', ' ', ' ', ' ', ' ', ' ', ' ', ' ', '#', ' ', ' ', ' ', ' ', '#', ' ', ' ', ' ', ' ', ' ', ' ', ' ', ' ', ' ', ' ', ' ', '#', 
     '#', ' ', ' ', ' ', '#', ' ', ' ', '#', ' ', ' ', ' ', ' ', ' ', ' ', ' ', ' ', ' ', ' ', ' ', ' ', ' ', '#', ' ', ' ', ' ', ' ', '#', ' ', ' ', ' ', '#', '#', '#', '#', '#', '#', '#', '#', '#', '#', '#', '#', '#', '#', '#', '#', '#', '#', ' ', ' ', ' ', '#', ' ', ' ', ' ', ' ', ' ', '#', ' ', ' ', ' ', ' ', ' ', '#', 
     '#', ' ', ' ', ' ', '#', ' ', ' ', '#', ' ', ' ', ' ', ' ', ' ', ' ', ' ', ' ', ' ', ' ', ' ', ' ', ' ', '#', ' ', ' ', ' ', ' ', '#', ' ', ' ', ' ', ' ', ' ', ' ', ' ', ' ', ' ', ' ', ' ', ' ', ' ', ' ', ' ', ' ', ' ', ' ', ' ', ' ', '#', ' ', ' ', ' ', '#', ' ', ' ', ' ', ' ', ' ', '#', ' ', ' ', ' ', ' ', ' ', '#', 
     '#', ' ', ' ', ' ', '#', ' ', ' ', '#', ' ', ' ', ' ', ' ', ' ', ' ', ' ', ' ', ' ', ' ', ' ', ' ', ' ', '#', ' ', ' ', ' ', ' ', '#', ' ', ' ', ' ', ' ', ' ', ' ', ' ', ' ', ' ', ' ', ' ', ' ', ' ', ' ', ' ', ' ', ' ', ' ', ' ', ' ', '#', ' ', ' ', ' ', '#', ' ', ' ', ' ', '#', '#', '#', '#', '#', ' ', ' ', ' ', '#', 
     '#', '#', '#', '#', '#', ' ', ' ', '#', ' ', ' ', ' ', '#', '#', '#', '#', '#', '#', '#', ' ', ' ', ' ', '#', ' ', ' ', ' ', ' ', '#', ' ', ' ', ' ', ' ', ' ', ' ', ' ', ' ', ' ', ' ', ' ', ' ', ' ', ' ', ' ', ' ', ' ', ' ', ' ', ' ', '#', ' ', ' ', ' ', '#', ' ', ' ', ' ', '#', ' ', ' ', ' ', '#', ' ', ' ', ' ', '#', 
     '#', ' ', ' ', ' ', ' ', ' ', ' ', '#', ' ', ' ', ' ', '#', ' ', ' ', ' ', ' ', ' ', '#', ' ', ' ', ' ', '#', ' ', ' ', ' ', ' ', '#', '#', '#', '#', '#', '#', '#', '#', '#', '#', '#', '#', '#', '#', '#', '#', '#', '#', ' ', ' ', ' ', '#', ' ', ' ', ' ', '#', ' ', ' ', ' ', '#', ' ', ' ', ' ', '#', ' ', ' ', ' ', '#', 
     '#', ' ', ' ', ' ', ' ', ' ', ' ', '#', ' ', ' ', ' ', '#', ' ', ' ', ' ', ' ', ' ', '#', ' ', ' ', ' ', '#', ' ', ' ', ' ', ' ', ' ', ' ', ' ', ' ', ' ', ' ', ' ', ' ', ' ', ' ', ' ', ' ', ' ', ' ', ' ', ' ', ' ', '#', ' ', ' ', ' ', '#', ' ', ' ', ' ', '#', ' ', ' ', ' ', ' ', ' ', ' ', ' ', '#', ' ', ' ', ' ', '#', 
     '#', ' ', ' ', ' ', ' ', ' ', ' ', '#', ' ', ' ', ' ', '#', ' ', ' ', ' ', ' ', ' ', '#', ' ', ' ', ' ', '#', ' ', ' ', ' ', ' ', ' ', ' ', ' ', ' ', ' ', ' ', ' ', ' ', ' ', ' ', ' ', ' ', ' ', ' ', ' ', ' ', ' ', '#', ' ', ' ', ' ', '#', ' ', ' ', ' ', '#', ' ', ' ', ' ', ' ', ' ', ' ', ' ', '#', ' ', ' ', ' ', '#', 
     '#', ' ', ' ', ' ', ' ', ' ', ' ', '#', ' ', ' ', ' ', '#', ' ', ' ', ' ', ' ', ' ', '#', ' ', ' ', ' ', '#', ' ', ' ', ' ', ' ', ' ', ' ', ' ', ' ', ' ', ' ', ' ', ' ', ' ', ' ', ' ', ' ', ' ', ' ', ' ', ' ', ' ', '#', ' ', ' ', ' ', '#', ' ', ' ', ' ', '#', ' ', ' ', ' ', ' ', ' ', ' ', ' ', '#', ' ', ' ', ' ', '#', 
     '#', ' ', ' ', ' ', ' ', ' ', ' ', '#', ' ', ' ', ' ', '#', ' ', ' ', ' ', ' ', ' ', '#', ' ', ' ', ' ', '#', '#', ' ', ' ', ' ', '#', '#', '#', '#', '#', '#', '#', '#', '#', '#', '#', '#', '#', '#', '#', '#', '#', '#', ' ', ' ', ' ', '#', ' ', ' ', ' ', '#', '#', '#', '#', '#', '#', '#', '#', '#', ' ', ' ', ' ', '#', 
     '#', ' ', ' ', ' ', ' ', ' ', ' ', '#', ' ', ' ', ' ', '#', ' ', ' ', ' ', ' ', ' ', '#', ' ', ' ', ' ', ' ', ' ', ' ', ' ', ' ', ' ', ' ', ' ', ' ', ' ', ' ', ' ', ' ', ' ', ' ', ' ', ' ', ' ', ' ', ' ', ' ', ' ', ' ', ' ', ' ', ' ', '#', ' ', ' ', ' ', ' ', ' ', ' ', ' ', '#', ' ', ' ', ' ', '#', ' ', ' ', ' ', '#', 
     '#', ' ', ' ', ' ', '#', '#', '#', '#', ' ', ' ', ' ', '#', ' ', ' ', ' ', ' ', ' ', '#', ' ', ' ', ' ', ' ', ' ', ' ', ' ', ' ', ' ', ' ', ' ', ' ', ' ', ' ', ' ', ' ', ' ', ' ', ' ', ' ', ' ', ' ', ' ', ' ', ' ', ' ', ' ', ' ', ' ', '#', ' ', ' ', ' ', ' ', ' ', ' ', ' ', '#', ' ', ' ', ' ', '#', ' ', ' ', ' ', '#', 
     '#', ' ', ' ', ' ', ' ', ' ', ' ', '#', ' ', ' ', ' ', '#', ' ', ' ', ' ', ' ', ' ', '#', ' ', ' ', ' ', ' ', ' ', ' ', ' ', ' ', ' ', ' ', ' ', ' ', ' ', ' ', ' ', ' ', ' ', ' ', ' ', ' ', ' ', ' ', ' ', ' ', ' ', ' ', ' ', ' ', ' ', '#', ' ', ' ', ' ', ' ', ' ', ' ', ' ', '#', ' ', ' ', ' ', '#', ' ', ' ', ' ', '#', 
     '#', ' ', ' ', ' ', ' ', ' ', ' ', '#', ' ', ' ', ' ', '#', ' ', ' ', ' ', ' ', ' ', '#', '#', '#', '#', '#', '#', '#', '#', '#', '#', '#', '#', '#', '#', '#', '#', '#', '#', '#', '#', '#', '#', '#', '#', '#', '#', '#', '#', '#', '#', '#', ' ', ' ', ' ', '#', ' ', ' ', ' ', '#', ' ', ' ', ' ', '#', ' ', ' ', ' ', '#', 
     '#', ' ', ' ', ' ', ' ', ' ', ' ', '#', ' ', ' ', ' ', '#', ' ', ' ', ' ', ' ', ' ', ' ', ' ', ' ', ' ', ' ', ' ', ' ', ' ', ' ', ' ', ' ', ' ', ' ', ' ', ' ', ' ', ' ', ' ', ' ', ' ', ' ', ' ', ' ', ' ', ' ', ' ', ' ', ' ', ' ', ' ', ' ', ' ', ' ', ' ', '#', ' ', ' ', ' ', ' ', ' ', ' ', ' ', '#', ' ', ' ', ' ', '#', 
     '#', ' ', ' ', ' ', ' ', ' ', ' ', ' ', ' ', ' ', ' ', '#', '#', '#', ' ', ' ', ' ', ' ', ' ', ' ', ' ', ' ', ' ', ' ', ' ', ' ', ' ', ' ', ' ', ' ', ' ', ' ', ' ', ' ', ' ', ' ', ' ', ' ', ' ', ' ', ' ', ' ', ' ', ' ', ' ', ' ', ' ', ' ', ' ', ' ', ' ', '#', ' ', ' ', ' ', ' ', ' ', ' ', ' ', '#', ' ', ' ', ' ', '#', 
     '#', '#', '#', '#', '#', ' ', ' ', ' ', ' ', ' ', ' ', ' ', ' ', ' ', ' ', ' ', ' ', ' ', ' ', ' ', ' ', ' ', ' ', ' ', ' ', ' ', ' ', ' ', ' ', '#', ' ', ' ', ' ', ' ', ' ', ' ', ' ', ' ', ' ', ' ', ' ', ' ', ' ', ' ', ' ', ' ', ' ', ' ', ' ', ' ', ' ', '#', ' ', ' ', ' ', ' ', ' ', ' ', ' ', '#', ' ', ' ', ' ', '#', 
     '#', ' ', ' ', ' ', ' ', ' ', ' ', ' ', ' ', ' ', ' ', ' ', ' ', ' ', ' ', ' ', ' ', ' ', ' ', ' ', ' ', ' ', ' ', ' ', ' ', ' ', '#', '#', '#', '#', '#', '#', '#', '#', '#', '#', '#', '#', '#', '#', '#', '#', '#', '#', '#', '#', '#', '#', '#', '#', '#', '#', '#', '#', '#', '#', '#', '#', '#', '#', ' ', ' ', ' ', '#', 
     '#', ' ', ' ', ' ', ' ', ' ', ' ', '#', ' ', ' ', ' ', ' ', ' ', ' ', ' ', ' ', ' ', ' ', ' ', ' ', ' ', ' ', ' ', ' ', ' ', ' ', ' ', ' ', ' ', ' ', ' ', ' ', ' ', ' ', ' ', ' ', ' ', ' ', ' ', ' ', ' ', ' ', ' ', '#', ' ', ' ', ' ', ' ', ' ', ' ', ' ', ' ', ' ', ' ', ' ', ' ', ' ', ' ', ' ', ' ', ' ', ' ', ' ', '#', 
     '#', ' ', ' ', ' ', ' ', ' ', ' ', '#', '#', '#', '#', '#', '#', '#', '#', '#', '#', '#', '#', '#', '#', '#', '#', ' ', ' ', ' ', ' ', ' ', ' ', ' ', ' ', ' ', ' ', ' ', ' ', ' ', ' ', ' ', ' ', ' ', ' ', ' ', ' ', '#', ' ', ' ', ' ', ' ', ' ', ' ', ' ', ' ', ' ', ' ', ' ', ' ', ' ', ' ', ' ', ' ', ' ', ' ', ' ', '#', 
     '#', ' ', ' ', ' ', ' ', ' ', ' ', ' ', ' ', ' ', ' ', ' ', ' ', ' ', ' ', ' ', ' ', ' ', ' ', ' ', ' ', ' ', '#', ' ', ' ', ' ', ' ', ' ', ' ', ' ', ' ', ' ', ' ', ' ', ' ', ' ', ' ', ' ', ' ', ' ', ' ', ' ', ' ', '#', ' ', ' ', ' ', ' ', ' ', ' ', ' ', ' ', ' ', ' ', ' ', ' ', ' ', ' ', ' ', ' ', ' ', ' ', ' ', '#', 
     '#', '#', '#', '#', '#', '#', '#', '#', '#', '#', '#', '#', '#', '#', '#', '#', '#', '#', '#', '#', '#', '#', '#', '#', '#', '#', '#', '#', '#', '#', '#', '#', '#', '#', '#', '#', '#', '#', '#', '#', '#', '#', '#', '#', '#', '#', '#', '#', '#', '#', '#', '#', '#', '#', '#', '#', '#', '#', '#', '#', '#', '#', '#', '#', 
];
